%%%%%%%%%
%.  P  .%
% % . % %
%   %   %
% .   .G%
%%%%%%%%%